######################################################
#                                                    #
#                                                    #
#                                                    #
#                                                    #
#                                                    #
#                                                    #
##################                       E           #
#                #                                   #
#           S    #                                   #
#                #                                   #
#                #                                   #
#                #                                   #
#                #                                   #
#                #                                   #
#                #                                   #
######################################################
