######################################################
#         #                        #                 #
#     #                                         E    #
#     #   #   #### ###             #                 #
###############      ####### #######   ###############
#             ########             #                 #
#               #                  #                 #
#               #       ############       ## ###### #
#########    #######           #   #       #   #   # #
#       #       #              #   #       #   # # ###
#   #   #####   #  ## #######  #           #    #    #
#   #   #       #  #     #  #      #       #     #   #
#  ######   #####  #     #  #  #   #   ###########   #
#    #                      #  #   #            #    #
#    ### S    ###############  #   #            K    #
#                      #       #   #                 #
######################################################
