######################################################
#                                                    #
#                                                    #
#                                                    #
#                                                    #
#                                                    #
#          #################                         #
#                          #              E          #
#                          #                         #
#                          #                         #
#      S                   #                         #
#                          #                         #
#                          #                         #
#          #################                         #
#                                                    #
#                                                    #
######################################################
