######################################################
#                                                    #
#                                                    #
#                                                    #
#                                                    #
#                                                    #
#                                                    #
#                                                    #
#                                                    #
#                                      E             #
#                          S                         #
#                                                    #
#                                                    #
#                                                    #
#                                                    #
#                                                    #
######################################################
