######################################################
#         #                        #                 #
#     #                                              #
#     #   #                        #                 #
############################ #######   ###############
#              #######             #                 #
#               #                  #                 #
#               #       ############       ###########
#########     ######           #   #       #         #
#       #       #              #   #       #         #
#   #   ###     #     #######  #   #       #     E   #
#   #   #       #           #      #       #         #
#  ######   #####           #  #   #   ###########   #
#           #               #  #   #            #    #
#      S         ############  #   #            #    #
#                      #       #   #                 #
######################################################
