######################################################
#                                                    #
#                     #                              #
#                     #                              #
#                     #                              #
#                     #                              #
#                     #                              #
#                     #              E               #
#                     #                              #
#                     #                              #
#      S              #                              #
#                     #                              #
#                     #                              #
#                     #                              #
#                                                    #
#                                                    #
######################################################
