111111111111111111111111111111111111111111111111111111
100000000010000000000000000000000001000000000000000001
100000100000000000000000000000000001000000000000000001
100000100010001111011100000000000001000000000000000001
100000111110001000000100000001111111000000000000000001
100000000000001111111100000000000001000000000000000001
100000000000000010000000000000000001000000000000000001
100000000000000010000000111111111111000000011111111101
111111111000011111110000000000010001000000010000000101
100000001000000010000000000000010001000000010000010111
100010001111100010011011111110010000000000010000010001
100010001000000010010000010010000001000000010000010001
100111111000111110010000010010010001000111110000110001
100001000000000000000000000010010001000000000000100001
10S00111000000111111111111111001000100000000000010K001
100000000000000000000001000000010001000000000000100001
111111111111111111111111111111111111111111111111111111
